"bq" = (/obj/structure/bombard,/turf/open/floor/rogue/sand,/area/rogue/outdoors/desert)
"bU" = (/obj/structure/bed/rogue/sleepingbag,/turf/open/floor/rogue/twig,/area/rogue/outdoors/desert)
"dx" = (/obj/effect/landmark/start/grenzelinfantry{dir = 1},/turf/open/floor/rogue/sand,/area/rogue/outdoors/desert)
"dT" = (/obj/machinery/light/rogue/forge,/turf/open/floor/rogue/sand,/area/rogue/outdoors/desert)
"eF" = (/turf/open/floor/rogue/sand,/area/rogue/outdoors/desert)
"fb" = (/obj/item/cooking/pan,/turf/open/floor/rogue/sand,/area/rogue/outdoors/desert)
"fK" = (/obj/item/rogueweapon/hammer,/turf/open/floor/rogue/sand,/area/rogue/outdoors/desert)
"gf" = (/obj/structure/bed/rogue/inn/hay,/turf/open/floor/rogue/twig,/area/rogue/outdoors/desert)
"gl" = (/obj/structure/warfarebarrier/red,/obj/effect/shadow{dir = 4},/turf/open/floor/rogue/sand,/area/rogue/outdoors/desert)
"gT" = (/turf/open/floor/rogue/grass,/area/rogue/outdoors/desert)
"hC" = (/obj/structure/bombard/alt{dir = 1},/turf/open/floor/rogue/sand,/area/rogue/outdoors/desert)
"hP" = (/obj/structure/table/wood/treestump/burnt{pixel_x = -32},/turf/open/floor/rogue/sand,/area/rogue/outdoors/desert)
"iJ" = (/obj/effect/landmark/start/grenzellord{dir = 1},/turf/open/floor/rogue/sand,/area/rogue/outdoors/desert)
"kK" = (/obj/structure/warfarebarrier/red,/turf/open/floor/rogue/sand,/area/rogue/outdoors/desert)
"ml" = (/obj/effect/landmark/start/heartfeltinfantry,/turf/open/floor/rogue/sand,/area/rogue/outdoors/desert)
"mq" = (/obj/structure/closet/crate/chest,/obj/item/ingot/steel,/obj/item/ingot/steel,/obj/item/ingot/steel,/obj/item/ingot/steel,/obj/item/ingot/steel,/obj/item/ingot/steel,/obj/item/ingot/steel,/obj/item/ingot/steel,/obj/item/ingot/steel,/obj/item/ingot/steel,/obj/item/ingot/steel,/obj/item/ingot/steel,/obj/item/ingot/steel,/obj/item/ingot/steel,/obj/item/ingot/steel,/obj/item/ingot/steel,/obj/item/ingot/steel,/obj/item/ingot/steel,/turf/open/floor/rogue/sand,/area/rogue/outdoors/desert)
"my" = (/turf/open/floor/rogue/grass{dir = 1},/area/rogue/outdoors/desert)
"mZ" = (/obj/structure/flora/roguetree,/turf/open/floor/rogue/grass,/area/rogue/outdoors/desert)
"np" = (/mob/living/simple_animal/hostile/retaliate/rogue/horse/tame/saddled,/turf/open/floor/rogue/sand,/area/rogue/outdoors/desert)
"oe" = (/obj/effect/shadow{dir = 4},/obj/effect/shadow{dir = 1},/turf/open/floor/rogue/sand,/area/rogue/outdoors/desert)
"oC" = (/obj/structure/warfarebarrier,/turf/open/floor/rogue/sand,/area/rogue/outdoors/desert)
"pn" = (/obj/structure/closet/crate/chest,/obj/item/bomb,/obj/item/bomb,/obj/item/bomb,/obj/item/bomb,/obj/item/bomb,/obj/item/bomb,/obj/item/bomb,/obj/item/bomb,/obj/item/bomb,/obj/item/bomb,/turf/open/floor/rogue/sand,/area/rogue/outdoors/desert)
"pq" = (/obj/structure/bed/rogue/inn/pileofshit,/turf/open/floor/rogue/twig,/area/rogue/outdoors/desert)
"qq" = (/turf/open/floor/rogue/twig,/area/rogue/outdoors/desert)
"rw" = (/obj/effect/shadow,/obj/effect/shadow{dir = 4},/turf/open/floor/rogue/sand,/area/rogue/outdoors/desert)
"rS" = (/obj/structure/warobjective/ponr,/turf/open/floor/rogue/sand,/area/rogue/outdoors/desert)
"sj" = (/obj/item/reagent_containers/glass/bucket/wooden,/turf/open/floor/rogue/sand,/area/rogue/outdoors/desert)
"sM" = (/obj/item/grown/log/tree/small,/turf/open/floor/rogue/twig,/area/rogue/outdoors/desert)
"tV" = (/obj/structure/closet/crate/chest,/obj/item/reagent_containers/food/snacks/rogue/meat/steak,/obj/item/reagent_containers/food/snacks/rogue/meat/steak,/obj/item/reagent_containers/food/snacks/rogue/meat/steak,/obj/item/reagent_containers/food/snacks/rogue/meat/steak,/obj/item/reagent_containers/food/snacks/rogue/meat/steak,/obj/item/reagent_containers/food/snacks/rogue/meat/steak,/obj/item/reagent_containers/food/snacks/rogue/meat/steak,/obj/item/reagent_containers/food/snacks/rogue/meat/steak,/obj/item/reagent_containers/food/snacks/rogue/meat/steak,/obj/item/reagent_containers/food/snacks/rogue/meat/steak,/turf/open/floor/rogue/sand,/area/rogue/outdoors/desert)
"vu" = (/obj/item/roguebin/water/gross,/turf/open/floor/rogue/sand,/area/rogue/outdoors/desert)
"wa" = (/obj/effect/shadow{dir = 4},/turf/open/floor/rogue/sand,/area/rogue/outdoors/desert)
"wG" = (/obj/item/grown/log/tree/small,/obj/item/grown/log/tree/small,/obj/item/grown/log/tree/small,/obj/item/grown/log/tree/small,/obj/item/grown/log/tree/small,/obj/item/grown/log/tree/small,/obj/item/grown/log/tree/small,/obj/item/grown/log/tree/small,/obj/item/grown/log/tree/small,/obj/item/grown/log/tree/small,/obj/item/grown/log/tree/small,/obj/structure/closet/crate/chest,/turf/open/floor/rogue/twig,/area/rogue/outdoors/desert)
"xv" = (/obj/structure/warfarebarrier,/obj/effect/shadow{dir = 8},/turf/open/floor/rogue/sand,/area/rogue/outdoors/desert)
"zw" = (/turf/open/water/cleanshallow,/area/rogue/outdoors/desert)
"zJ" = (/obj/effect/landmark/redreinforcement,/turf/open/floor/rogue/sand,/area/rogue/outdoors/desert)
"AE" = (/obj/effect/shadow{dir = 8},/turf/open/floor/rogue/sand,/area/rogue/outdoors/desert)
"Br" = (/obj/effect/shadow{dir = 8},/obj/effect/shadow{dir = 1},/turf/open/floor/rogue/sand,/area/rogue/outdoors/desert)
"CE" = (/obj/structure/closet/crate/chest,/obj/item/grown/log/tree,/obj/item/grown/log/tree,/obj/item/grown/log/tree,/obj/item/grown/log/tree,/obj/item/grown/log/tree,/obj/item/grown/log/tree,/obj/item/grown/log/tree,/obj/item/grown/log/tree,/obj/item/grown/log/tree,/obj/item/grown/log/tree,/obj/item/grown/log/tree,/obj/item/grown/log/tree,/obj/item/grown/log/tree,/obj/item/grown/log/tree,/turf/open/floor/rogue/twig,/area/rogue/outdoors/desert)
"CS" = (/obj/item/grown/log/tree/stick,/turf/open/floor/rogue/sand,/area/rogue/outdoors/desert)
"Dn" = (/obj/machinery/light/rogue/hearth,/obj/item/cooking/pan,/turf/open/floor/rogue/sand,/area/rogue/outdoors/desert)
"DO" = (/obj/structure/chair/bench/ancientlog,/turf/open/floor/rogue/grass,/area/rogue/outdoors/desert)
"Er" = (/obj/effect/landmark/start/grenzelinfantry{dir = 1},/obj/effect/shadow,/turf/open/floor/rogue/sand,/area/rogue/outdoors/desert)
"GN" = (/obj/effect/shadow,/turf/open/floor/rogue/sand,/area/rogue/outdoors/desert)
"GZ" = (/obj/item/ingot/steel,/turf/open/floor/rogue/sand,/area/rogue/outdoors/desert)
"Hk" = (/obj/structure/fermenting_barrel/water,/turf/open/floor/rogue/sand,/area/rogue/outdoors/desert)
"Hl" = (/obj/structure/warfarebarrier,/obj/effect/shadow{dir = 4},/turf/open/floor/rogue/sand,/area/rogue/outdoors/desert)
"HH" = (/obj/effect/landmark/events/haunts,/turf/open/floor/rogue/sand,/area/rogue/outdoors/desert)
"Il" = (/obj/structure/fermenting_barrel/beer,/turf/open/floor/rogue/sand,/area/rogue/outdoors/desert)
"Jm" = (/obj/structure/flora/roguetree/burnt,/turf/open/floor/rogue/sand,/area/rogue/outdoors/desert)
"Jt" = (/obj/structure/warobjective/ponr/red,/turf/open/floor/rogue/sand,/area/rogue/outdoors/desert)
"KB" = (/obj/effect/shadow{dir = 8},/obj/effect/shadow,/obj/effect/landmark/mapGenerator/sunlights{endTurfX = 50; endTurfY = 127},/turf/open/floor/rogue/sand,/area/rogue/outdoors/desert)
"KO" = (/obj/effect/shadow{dir = 1},/turf/open/floor/rogue/sand,/area/rogue/outdoors/desert)
"LY" = (/obj/item/flint,/turf/open/floor/rogue/sand,/area/rogue/outdoors/desert)
"NM" = (/obj/machinery/light/rogue/hearth,/turf/open/floor/rogue/sand,/area/rogue/outdoors/desert)
"Ol" = (/obj/effect/landmark/start/heartfeltlord,/turf/open/floor/rogue/twig,/area/rogue/outdoors/desert)
"ON" = (/obj/effect/spawner/roguemap/grass_low,/turf/open/floor/rogue/grass,/area/rogue/outdoors/desert)
"Pi" = (/obj/structure/warfarebarrier/red,/obj/effect/shadow{dir = 8},/turf/open/floor/rogue/sand,/area/rogue/outdoors/desert)
"PA" = (/obj/structure/fluff/grindwheel,/turf/open/floor/rogue/sand,/area/rogue/outdoors/desert)
"PN" = (/turf/closed/wall/mineral/rogue/wooddark,/area/rogue/outdoors/desert)
"Qf" = (/obj/item/grown/log/tree/small,/turf/open/floor/rogue/sand,/area/rogue/outdoors/desert)
"Qh" = (/obj/structure/chair/bench/ancientlog,/turf/open/floor/rogue/sand,/area/rogue/outdoors/desert)
"QK" = (/obj/structure/table/wood/treestump/burnt,/turf/open/floor/rogue/sand,/area/rogue/outdoors/desert)
"SF" = (/obj/machinery/light/rogue/torchholder/r,/turf/open/floor/rogue/twig,/area/rogue/outdoors/desert)
"SY" = (/obj/item/rogueweapon/tongs,/turf/open/floor/rogue/sand,/area/rogue/outdoors/desert)
"TN" = (/obj/machinery/anvil,/turf/open/floor/rogue/sand,/area/rogue/outdoors/desert)
"Uq" = (/obj/effect/landmark/events/haunts,/turf/open/floor/rogue/twig,/area/rogue/outdoors/desert)
"Ww" = (/obj/machinery/light/rogue/torchholder/r,/turf/open/floor/rogue/sand,/area/rogue/outdoors/desert)
"Xm" = (/obj/structure/flora/roguetree/wise,/turf/open/floor/rogue/grass,/area/rogue/outdoors/desert)
"XF" = (/obj/machinery/light/rogue/torchholder/c,/turf/open/floor/rogue/sand,/area/rogue/outdoors/desert)
"Yn" = (/obj/effect/landmark/blureinforcement,/turf/open/floor/rogue/sand,/area/rogue/outdoors/desert)
"Ys" = (/obj/effect/landmark/observer_start,/turf/open/water/cleanshallow,/area/rogue/outdoors/desert)
"YM" = (/obj/item/grown/log/tree/stick,/turf/open/floor/rogue/twig,/area/rogue/outdoors/desert)
"Zv" = (/obj/item/flint,/turf/open/floor/rogue/twig,/area/rogue/outdoors/desert)

(1,1,1) = {"
BrKOKOKOKOKOKOKOKOKOKOKOKOKOKOKOKOKOKOKOKOKOKOKOKOKOKOKOKOKOKOKOKOKOKOKOKOKOKOKOKOKOKOKOKOKOKOKOKOoe
AEeFeFeFeFeFeFeFeFeFeFeFeFeFeFeFeFeFeFeFeFeFeFeFeFeFeFeFeFeFeFeFeFeFeFeFeFeFeFeFeFeFeFeFeFeFeFeFeFwa
AEeFeFJmeFeFeFeFeFeFeFeFqqeFeFeFeFeFeFeFmleFeFeFeFeFeFeFeFeFeFeFeFJmeFeFeFeFeFeFeFeFeFeFeFeFeFeFeFwa
AEeFeFeFeFeFeFeFeFqqeFqqqqqqqqeFeFeFeFmlnpmleFeFeFeFeFtVDneFeFeFeFeFeFeFeFeFeFeFeFeFeFeFmleFeFeFeFwa
AEeFeFeFeFeFeFeFqqqqqqqqqqPNPNqqeFeFeFeFmleFeFeFeFeFeFNMtVeFeFeFeFeFeFeFeFeFJmeFeFeFeFmlnpmleFeFeFwa
AEeFeFeFeFeFeFqqqqqqPNqqqqwGPNPNPNeFeFeFeFeFzJeFeFeFeFeFeFeFeFeFeFeFeFeFeFeFHHeFeFeFeFeFmleFeFeFeFwa
AEeFeFeFeFeFeFeFeFqqPNPNqqqqqqUqPNeFeFeFeFeFeFeFeFeFeFeFeFeFeFIleFeFeFeFeFeFeFeFeFeFeFeFeFeFeFeFeFwa
AEeFeFeFeFeFeFeFeFeFeFPNbUqqqqqqPNPNeFeFeFeFeFeFeFeFeFmleFeFeFeFeFeFeFeFeFeFeFeFeFeFeFeFeFeFeFeFeFwa
AEeFeFeFeFeFeFeFeFeFeFPNPNqqqqqqwGPNpneFeFeFeFeFeFeFmlnpmleFeFeFeFmleFeFeFeFeFeFeFeFeFdTeFSYeFeFeFwa
AEeFHHeFeFeFeFeFeFeFeFeFPNPNZvqqqqPNeFeFeFeFeFeFeFeFeFmleFeFIleFmlnpmlIleFeFeFmleFmqGZeFeFTNeFeFeFwa
AEeFeFeFeFeFeFeFeFeFeFeFeFCEOlqqqqeFeFeFeFJmeFeFeFeFeFIleFeFeFsjeFmleFeFeFeFmlnpmleFeFfKeFeFeFeFeFwa
AEeFeFeFJmeFeFeFeFeFeFeFeFeFeFqqeFeFeFeFeFeFeFeFeFeFeFeFsjeFeFIleFeFIleFeFeFeFmleFeFPAeFGZeFHHeFeFwa
AEeFeFeFeFeFeFeFeFeFeFeFeFLYeFeFeFeFeFeFeFeFJteFeFeFeFIleFeFeFeFeFeFeFeFeFeFeFeFeFeFeFeFeFeFeFeFeFwa
AEeFeFeFeFeFeFeFeFeFeFeFeFeFeFeFeFeFeFeFeFeFeFeFeFeFeFeFeFeFeFeFeFeFeFeFIleFeFeFeFeFeFeFeFeFeFeFeFwa
AEeFeFeFeFeFeFeFeFeFeFeFeFeFeFeFeFeFeFeFeFeFeFeFeFeFeFeFeFeFeFIleFeFIleFeFeFeFeFeFeFeFeFeFeFeFeFeFwa
AEeFeFeFeFeFeFeFeFJmeFeFeFeFeFeFeFeFeFeFeFeFeFeFeFeFeFeFeFeFeFeFeFeFeFeFeFeFeFeFeFeFeFeFeFvueFeFeFwa
AEeFeFeFeFeFeFeFeFeFeFeFeFeFeFeFeFHHeFeFeFeFeFeFeFeFeFeFeFeFeFeFeFeFeFeFeFeFeFeFeFeFeFeFeFeFeFeFeFwa
AEeFeFeFeFeFeFeFeFeFeFeFeFeFeFeFeFeFeFeFeFeFeFeFeFeFbqeFeFeFeFHHeFeFeFeFeFeFeFeFeFeFeFeFeFeFeFeFeFwa
AEeFeFeFeFeFeFeFeFeFeFHHeFeFeFeFeFeFeFeFeFeFeFJmeFeFeFeFeFeFeFeFeFeFeFeFeFeFeFeFeFeFeFeFeFeFeFeFbqwa
AEeFeFeFeFeFeFeFeFeFeFeFeFeFeFeFeFeFeFeFeFeFeFeFeFeFeFeFeFeFeFeFQKeFeFeFeFeFeFeFeFeFeFeFeFeFeFeFeFwa
AEeFeFeFeFeFeFbqeFeFeFeFeFeFeFeFeFJmeFeFeFeFeFeFeFeFeFeFeFeFeFeFeFeFeFeFbqeFeFJmeFeFeFeFeFeFeFeFeFwa
AEeFeFeFeFeFeFeFeFeFeFeFeFeFeFeFeFeFeFeFeFeFeFeFHHeFeFeFeFeFPNeFeFeFeFeFeFeFeFeFeFeFeFeFeFeFJmeFeFwa
AEeFJmeFeFeFeFeFeFeFeFeFeFeFeFbqeFeFeFeFeFeFeFeFeFeFeFeFeFeFeFeFeFeFeFeFeFeFeFeFeFeFeFeFeFeFeFeFeFwa
AEeFeFeFeFeFeFeFeFeFeFeFeFeFeFeFeFeFeFeFeFeFeFeFeFeFeFeFeFeFeFeFeFeFeFeFeFeFeFbqeFeFeFeFeFeFeFeFeFwa
AEeFeFeFeFeFeFeFeFeFeFeFeFeFeFeFQKeFeFeFeFeFeFeFeFeFeFeFJmeFeFeFeFeFHHeFeFeFeFeFeFeFeFeFeFeFeFeFeFwa
AEeFeFeFeFeFeFeFeFeFeFeFeFeFeFeFeFeFeFeFeFeFeFeFeFeFeFeFeFeFeFeFeFeFeFeFeFeFeFeFeFeFeFeFeFeFeFeFeFwa
AEeFeFeFeFeFeFeFeFeFeFeFeFeFeFeFeFeFeFeFeFeFeFeFeFeFeFeFeFeFeFeFeFeFeFeFeFeFeFeFeFeFeFeFeFeFeFeFeFwa
PikKkKkKkKkKkKkKkKkKkKkKkKkKkKkKkKkKkKkKkKkKkKkKkKkKkKkKkKkKkKkKkKkKkKkKkKkKkKkKkKkKkKkKkKkKkKkKkKgl
AEeFeFeFeFeFJmeFeFeFeFeFeFeFeFeFeFeFeFeFeFeFeFeFeFeFeFeFeFeFeFeFeFeFeFeFeFeFeFeFeFeFeFeFeFeFeFeFeFwa
AEeFeFeFeFeFeFeFeFeFeFeFeFeFeFeFeFeFeFeFeFHHJmeFeFeFeFeFeFeFeFeFeFeFeFeFPNPNPNPNPNeFeFeFeFeFeFeFeFwa
AEeFeFeFeFeFeFeFeFeFeFeFeFeFeFeFeFeFeFeFeFeFeFeFeFeFeFeFeFeFeFeFeFeFeFeFqqYMqqgfPNeFeFeFeFeFeFeFeFwa
AEeFeFHHeFeFeFeFeFeFeFeFeFeFeFeFeFeFeFeFeFeFeFeFeFeFeFeFeFeFeFeFeFeFeFeFPNqqqqqqPNeFeFeFeFeFeFeFeFwa
AEeFeFHHeFeFeFeFeFeFeFeFHHeFeFeFeFeFeFeFeFeFeFeFeFeFeFeFHHeFeFeFeFeFeFeFPNqqqqSFPNeFeFJmeFeFeFeFeFwa
AEeFeFeFeFeFeFeFeFeFeFeFeFeFeFeFeFeFeFeFeFeFeFeFeFeFeFeFeFeFeFeFeFJmeFeFPNqqqqqqYMeFeFeFeFeFeFeFeFwa
AEeFeFeFeFeFeFeFeFeFeFeFeFeFeFeFeFeFeFeFeFeFeFeFeFeFeFeFeFeFeFeFeFeFeFeFPNqqUqqqYMeFeFeFeFeFeFeFeFwa
AEeFeFeFeFeFeFeFeFeFeFeFJmeFeFeFeFeFeFeFeFeFeFeFeFeFeFeFeFeFeFeFeFeFeFeFPNPNqqPNPNeFeFeFeFeFeFeFeFwa
AEeFeFeFeFeFeFeFeFeFeFeFeFeFeFeFeFeFeFeFeFeFeFeFeFeFeFeFeFeFeFeFQKeFeFeFeFeFeFeFeFeFeFeFeFeFeFeFeFwa
AEeFeFeFeFeFeFeFeFeFeFeFeFeFeFeFeFeFeFeFeFeFeFeFHHeFeFeFeFeFeFeFeFeFeFeFeFeFCSeFeFeFeFJmeFeFeFeFeFwa
AEeFeFeFHHeFeFeFeFeFeFeFeFeFeFeFQheFeFeFeFeFeFeFeFeFJmeFeFeFeFeFeFeFeFeFeFeFeFeFeFCSeFeFeFeFeFeFeFwa
AEeFeFeFeFeFeFJmeFeFeFeFeFeFeFeFeFeFeFeFeFeFeFeFeFeFeFeFeFeFeFeFeFeFeFeFeFeFeFeFeFeFeFeFeFeFeFeFeFwa
AEeFeFeFeFeFeFeFeFeFPNPNPNeFeFeFeFeFeFeFeFeFeFeFeFeFeFeFeFeFeFeFeFeFeFeFeFeFeFeFeFeFeFeFHHeFeFeFeFwa
AEeFeFeFeFeFeFeFeFeFPNPNPNeFeFeFeFeFeFeFeFeFeFeFPNeFeFeFeFeFeFeFeFeFeFJmeFeFeFeFeFeFeFeFeFeFeFeFeFwa
AEeFeFeFeFeFeFeFeFeFPNPNPNeFeFeFeFeFeFeFeFeFeFeFeFeFeFeFeFeFeFeFeFeFeFeFeFeFeFeFeFeFeFeFeFeFeFeFeFwa
AEeFeFeFeFeFeFeFeFeFeFeFeFeFeFeFeFeFeFeFeFeFeFeFeFeFeFeFeFeFeFeFeFeFeFeFeFeFeFeFeFeFeFeFeFeFeFeFeFwa
AEeFeFeFeFeFeFeFeFeFHHeFeFeFQKeFeFeFeFJmeFeFeFeFeFeFeFeFeFeFeFeFeFeFeFeFeFeFeFeFeFeFeFeFeFeFeFeFeFwa
AEeFeFeFeFeFeFeFeFeFeFeFeFeFeFeFeFeFeFeFeFeFeFeFeFeFeFeFeFeFeFeFeFeFeFeFeFeFeFeFeFeFeFeFeFeFeFeFeFwa
AEeFeFeFeFeFeFeFeFeFeFeFeFeFeFeFeFeFeFeFeFeFeFeFeFeFeFeFeFHHeFeFeFeFeFeFeFeFeFeFeFeFeFeFeFeFeFeFeFwa
AEeFeFeFeFeFeFeFeFeFeFeFeFeFeFeFeFeFeFeFeFeFeFeFeFeFeFeFeFeFeFeFeFeFeFeFeFeFHHeFeFeFeFeFeFeFeFeFeFwa
AEeFeFeFeFeFeFeFeFeFeFeFeFeFeFeFeFeFeFeFeFeFeFeFeFeFJmeFeFeFeFeFeFeFPNPNPNeFeFeFeFeFeFJmeFeFeFeFeFwa
AEeFeFeFeFeFeFeFeFeFeFeFeFeFeFeFeFeFeFeFeFeFeFeFeFeFeFeFeFeFeFeFeFeFPNPNPNeFeFeFeFeFeFeFeFeFeFeFeFwa
AEeFeFeFeFJmeFeFeFeFeFeFeFeFeFeFHHeFeFeFeFONeFgTDOeFeFeFeFeFeFeFeFeFPNPNPNeFeFeFeFeFeFeFeFeFeFeFeFwa
AEeFeFeFeFeFeFeFeFeFeFeFeFeFeFeFeFeFeFeFeFeFgTgTONeFeFeFeFeFONeFeFeFeFeFeFeFeFeFeFeFeFeFeFeFeFeFeFwa
AEeFeFeFeFeFeFeFeFeFeFeFeFPNeFeFeFeFeFeFeFeFmyONgTgTONgTeFgTmZgTeFeFeFeFeFeFeFeFeFeFeFeFeFeFeFeFeFwa
AEeFeFeFeFeFeFeFeFeFeFeFeFeFeFeFeFeFeFeFONeFgTmyzwzwgTeFgTONgTgTONeFeFeFeFeFeFPNeFeFeFeFeFeFeFeFeFwa
AEeFeFeFeFeFeFeFeFeFeFeFeFeFeFeFeFeFeFgTgTgTzwONmZzwzwgTgTgTzwzwgTgTeFeFeFeFeFeFeFeFeFeFeFeFeFeFeFwa
AEeFeFeFeFeFeFeFeFeFeFeFeFeFeFeFeFeFgTgTONzwzwzwzwzwzwzwONzwzwzwgTeFeFeFeFeFeFeFQKeFeFeFeFeFeFeFeFwa
AEeFeFeFeFeFeFeFeFeFeFeFeFeFeFeFeFgTONgTzwzwzwzwzwzwzwzwzwzwzwgTeFeFeFeFeFeFeFeFeFeFeFeFeFeFeFeFeFwa
AEeFeFeFeFeFeFeFeFeFeFeFeFeFeFeFeFgTgTgTzwzwzwzwzwYszwzwzwzwgTgTONeFeFeFeFeFeFeFeFeFeFeFeFeFeFeFeFwa
AEeFeFeFeFeFeFHHeFeFeFJmeFeFeFeFeFeFgTONmZzwzwzwzwzwzwzwzwzwzweFeFeFeFeFeFeFHHeFeFJmeFeFeFeFeFeFeFwa
AEeFeFeFeFeFeFeFQKeFeFeFeFeFeFeFeFeFeFONgTONzwzwzwzwzwzwzwzwgTONeFeFeFeFeFeFeFeFeFeFeFeFeFeFeFeFeFwa
AEeFeFeFeFeFeFeFeFeFeFeFeFeFeFeFeFeFgTgTgTzwzwzwXmzwzwgTgTzwONgTeFeFeFeFeFeFeFeFeFeFeFeFeFeFeFeFeFwa
AEeFeFeFeFeFeFeFeFeFeFeFeFeFeFeFeFeFeFgTzwONgTgTgTzwzwzwgTmZgTeFeFeFeFeFeFeFeFeFeFeFeFeFeFeFeFeFeFwa
AEeFeFeFeFeFeFeFeFeFeFeFeFeFeFeFeFeFeFONgTgTeFgTONgTzwgTONgTeFeFeFeFeFeFeFeFeFeFeFeFeFeFeFeFeFeFeFwa
AEeFeFHHeFeFeFeFeFeFeFeFeFeFeFeFeFeFeFeFgTeFeFeFgTeFgTDOgTgTgTeFeFeFeFeFeFJmeFeFeFeFeFeFeFeFeFeFeFwa
AEeFeFeFeFeFPNPNPNPNeFeFeFeFeFJmeFeFeFeFeFeFeFeFeFeFeFgTeFONeFeFeFeFeFeFeFeFeFeFeFeFeFeFeFeFeFeFeFwa
AEeFeFeFqqQfqqqqpqqqeFeFeFeFeFeFeFeFeFeFeFeFeFeFeFeFeFeFeFeFeFeFeFeFeFeFeFeFeFeFeFeFeFeFeFeFQheFeFwa
AEeFeFqqqqqqqqqqqqqqqqeFPNeFeFeFeFeFeFeFeFeFeFeFeFeFeFeFeFeFeFeFeFeFeFeFeFeFeFeFeFeFeFeFeFeFeFeFeFwa
AEeFeFqqeFeFQfqqYMsMqqeFeFeFQKeFeFeFeFeFeFeFeFeFeFeFeFeFeFeFeFeFeFeFeFeFeFeFeFeFeFeFeFeFeFeFeFeFeFwa
AEeFeFeFeFeFeFeFqqqqYMeFeFeFeFeFeFeFeFeFeFeFQheFeFeFeFeFeFeFeFeFeFeFeFeFeFeFeFeFeFeFeFeFeFeFeFeFeFwa
AEeFeFeFeFeFeFeFqqeFsMsMeFeFeFeFeFeFeFeFeFeFeFeFeFeFeFeFeFeFeFeFeFeFeFeFeFeFeFeFeFeFeFeFeFeFeFeFeFwa
AEeFeFeFeFQheFeFeFeFeFeFeFeFeFeFeFeFeFeFeFeFeFeFeFeFeFeFQKeFeFeFeFeFeFeFeFeFeFeFJmeFeFeFeFeFeFeFeFwa
AEeFeFeFeFeFeFeFPNeFeFeFeFeFeFeFHHeFeFeFeFeFeFeFeFeFeFeFeFeFeFeFeFeFeFeFPNeFeFeFeFeFeFeFeFeFeFeFeFwa
AEeFeFeFeFeFeFeFeFeFeFeFeFeFeFeFeFeFeFeFeFPNeFeFeFeFeFeFeFeFeFeFeFeFeFeFHHeFeFeFeFeFeFeFeFeFeFeFeFwa
AEeFeFeFeFeFeFeFeFeFeFJmeFeFeFeFeFeFeFeFeFeFeFeFeFeFeFeFeFeFeFeFQheFeFeFeFeFeFeFeFeFeFeFeFeFeFeFeFwa
AEeFeFeFeFeFeFeFeFeFeFeFeFeFeFeFeFeFeFeFeFeFeFeFeFeFeFeFeFeFeFeFeFeFeFeFeFeFeFeFeFeFeFeFeFeFeFeFeFwa
AEeFeFeFeFeFeFeFeFeFeFeFeFeFeFeFeFeFeFeFeFeFeFeFeFeFeFeFeFeFeFeFeFeFeFeFeFeFeFeFeFeFeFeFeFHHeFeFeFwa
AEeFeFeFeFeFeFeFeFeFeFeFeFeFeFeFeFeFeFeFeFeFeFeFeFJmeFeFeFeFeFeFeFeFeFeFeFeFeFeFeFeFeFeFeFeFeFeFeFwa
AEeFeFeFeFeFeFeFeFeFeFeFeFeFeFeFeFeFeFeFeFeFQKeFeFeFeFeFeFeFeFeFeFeFeFeFeFeFeFeFeFeFeFeFeFeFeFeFeFwa
AEeFeFeFeFeFeFeFeFeFeFeFeFeFeFeFeFeFeFeFeFeFeFeFeFeFeFeFeFeFeFeFeFeFeFeFeFeFeFeFeFeFJmeFeFeFeFeFeFwa
AEeFeFeFeFeFeFeFeFPNeFeFeFeFeFeFJmeFeFeFeFeFeFeFeFeFeFeFeFeFeFeFeFeFeFeFeFeFeFeFeFeFeFeFeFeFeFeFeFwa
AEeFeFeFeFeFeFeFeFeFeFeFeFeFeFeFeFeFeFeFeFeFeFeFeFeFeFeFeFeFeFeFeFeFeFeFeFeFeFeFeFeFeFeFeFeFeFeFeFwa
AEeFeFeFeFeFeFeFeFeFeFeFeFeFeFeFeFeFeFeFeFeFeFeFeFeFPNPNPNPNeFeFeFeFJmeFeFeFeFeFeFeFeFeFeFeFeFeFeFwa
AEeFeFeFeFeFeFeFeFHHeFeFeFeFeFeFeFeFeFeFeFHHeFqqeFeFqqqqqqPNeFeFeFeFeFeFeFeFeFeFeFeFeFeFeFeFeFeFeFwa
AEeFeFeFeFeFeFeFeFeFeFeFeFeFeFeFeFeFeFeFeFeFeFeFeFqqqqqqqqPNeFeFeFeFeFeFeFeFeFeFeFeFeFeFeFeFeFeFeFwa
AEQKeFeFeFHHeFeFeFeFeFeFeFeFeFeFeFeFeFeFeFeFeFeFeFPNPNPNPNPNeFeFeFeFeFeFeFeFeFeFeFeFeFPNeFeFeFeFeFwa
AEeFeFeFeFeFeFeFeFeFeFeFeFeFeFJmeFeFeFeFeFeFeFeFeFeFeFeFeFeFJmeFeFeFeFeFeFeFeFeFeFeFeFeFeFeFeFeFeFwa
AEeFeFeFeFeFeFeFeFeFeFeFeFeFeFeFeFeFeFeFeFeFeFeFeFeFeFeFeFeFeFeFeFeFeFeFeFeFeFHHeFeFeFeFeFeFeFeFeFwa
AEeFeFeFeFeFeFeFeFeFeFeFeFeFeFeFeFeFeFeFeFeFeFeFeFeFeFeFeFeFeFeFeFeFeFeFeFeFeFeFeFeFeFeFeFeFeFHHeFwa
AEeFeFeFeFeFeFeFeFeFeFeFeFeFeFeFeFPNeFeFeFeFeFeFeFeFeFJmeFeFeFeFeFeFeFeFeFPNPNeFeFeFHHeFeFeFeFeFeFwa
AEeFeFeFeFeFeFeFeFeFeFeFeFeFeFeFeFeFeFeFeFPNeFeFeFeFeFeFeFeFeFeFeFeFeFeFeFPNPNeFeFeFeFeFeFeFeFeFeFwa
AEeFeFeFeFeFeFeFeFeFeFeFJmeFeFeFeFeFeFeFeFeFeFeFeFeFeFeFeFeFeFeFeFeFeFeFeFeFeFeFeFeFeFeFeFeFeFeFeFwa
AEeFeFeFeFeFeFeFeFeFeFeFeFeFeFeFeFeFeFeFeFeFeFeFeFeFeFeFeFeFeFeFeFeFeFeFeFeFeFeFeFeFeFJmeFeFeFeFeFwa
AEeFeFeFeFPNeFHHeFeFeFeFeFeFeFeFeFeFeFeFeFeFeFeFeFeFeFeFeFeFeFeFeFeFeFeFeFQKeFeFeFeFeFeFeFeFeFeFeFwa
AEeFeFeFeFeFeFeFeFeFeFeFeFeFeFeFeFeFeFeFQheFeFeFeFeFeFeFPNeFeFeFeFeFeFeFeFeFeFeFeFeFeFeFeFeFeFeFeFwa
AEeFeFeFeFeFeFeFPNeFeFeFeFeFeFeFeFeFeFeFeFeFeFeFeFeFeFeFeFeFeFeFeFeFeFeFeFeFeFeFeFeFeFeFeFeFeFeFeFwa
AEeFeFeFeFeFeFeFeFeFeFeFeFeFeFeFeFeFeFeFeFeFeFeFeFeFeFeFeFeFeFeFeFeFeFeFeFeFeFeFeFeFeFeFeFeFeFeFeFwa
AEeFeFeFeFeFeFeFeFeFeFeFeFHHeFeFeFeFeFeFeFeFeFeFeFeFeFeFeFeFeFeFJmeFeFeFeFeFeFeFeFeFeFeFeFeFeFeFeFwa
AEeFeFeFeFeFeFeFeFeFeFeFeFeFeFeFeFeFeFeFeFeFeFeFeFeFeFeFeFeFeFeFeFeFeFeFeFeFeFeFeFeFHHeFeFeFeFeFeFwa
AEeFeFeFeFeFeFeFeFeFeFeFeFeFeFeFeFeFeFeFeFeFeFeFeFeFeFeFeFeFeFeFeFeFeFeFeFeFeFeFeFeFeFeFeFeFeFeFeFwa
xvoCoCoCoCoCoCoCoCoCoCoCoCoCoCoCoCoCoCoCoCoCoCoCoCoCoCoCoCoCoCoCoCoCoCoCoCoCoCoCoCoCoCoCoCoCoCoCoCHl
AEeFeFeFeFeFeFeFeFJmeFeFeFeFeFeFeFeFeFeFeFeFeFeFeFeFeFeFeFeFeFeFeFeFeFeFeFeFeFeFeFeFeFeFeFeFeFeFeFwa
AEeFeFeFeFeFeFeFeFeFeFeFeFeFeFeFeFeFeFeFeFeFeFeFeFeFeFeFeFeFeFeFeFeFeFeFeFeFeFeFJmeFeFeFeFeFeFeFeFwa
AEeFeFeFeFeFeFeFeFeFeFeFeFeFQKeFeFeFeFeFeFeFeFeFeFeFeFeFeFeFeFeFeFeFeFPNeFeFeFeFeFeFeFeFeFeFeFeFeFwa
AEeFeFeFeFeFeFeFeFeFeFeFeFeFeFeFeFeFeFeFeFeFeFeFJmeFeFeFeFeFeFeFeFeFeFeFeFeFeFeFeFeFeFeFeFeFeFeFeFwa
AEeFeFeFeFeFeFeFeFeFeFeFeFeFeFeFeFeFeFeFeFeFeFeFeFeFeFeFeFeFeFeFeFeFeFeFeFeFeFeFeFeFeFeFeFeFeFeFeFwa
AEeFeFeFeFeFeFeFeFeFeFeFeFeFeFeFeFeFeFeFeFeFeFPNeFeFeFeFeFeFeFeFeFPNeFeFeFeFeFeFeFJmeFeFeFeFeFeFeFwa
AEeFeFeFeFeFeFeFeFeFeFeFHHeFeFeFeFeFJmeFeFeFeFeFeFeFeFeFeFeFeFeFeFeFeFeFeFeFeFeFeFeFeFeFeFeFeFJmeFwa
AEeFeFeFeFJmeFeFeFPNeFeFeFeFeFeFeFeFeFeFeFeFeFeFeFeFHHeFeFJmeFeFeFeFeFeFeFeFeFeFeFeFeFeFeFeFeFeFeFwa
AEeFeFeFeFeFeFeFeFeFeFeFeFeFeFeFeFeFPNeFeFeFeFeFeFeFeFeFeFeFeFeFeFeFeFeFeFeFeFeFeFeFeFeFeFeFeFeFeFwa
AEeFeFeFeFeFeFeFeFeFeFeFeFeFeFeFeFeFeFeFeFeFeFeFeFeFeFeFeFeFeFeFeFeFeFHHeFeFeFeFQKeFeFeFeFeFeFeFeFwa
AEeFeFeFeFeFeFHHeFeFeFeFeFQKeFeFeFeFeFeFeFeFeFeFeFeFeFeFeFeFeFeFeFeFeFeFeFeFeFeFeFeFeFeFeFeFeFeFeFwa
AEeFeFeFeFeFeFeFeFeFeFeFeFeFeFeFeFeFeFeFeFeFeFeFeFPNeFeFeFeFeFeFeFeFeFeFQKeFeFeFeFeFeFeFeFeFeFeFeFwa
AEeFeFeFeFeFeFeFeFeFeFeFeFeFeFeFeFeFeFeFJmeFeFeFeFeFeFeFeFeFJmeFeFeFeFeFeFeFeFeFeFeFeFeFeFeFeFeFeFwa
AEeFeFeFeFeFeFeFeFeFeFeFhPeFeFeFeFeFeFeFeFeFeFeFeFeFeFeFeFeFeFeFeFeFeFeFeFeFeFeFeFeFeFeFeFeFeFeFeFwa
AEeFeFeFeFeFhCeFeFeFeFeFeFeFeFeFeFeFeFeFeFeFeFeFeFeFeFeFeFeFeFeFeFeFeFeFeFeFeFeFhCeFeFeFeFeFeFeFeFwa
AEeFeFeFeFeFeFeFeFeFeFeFeFeFeFeFeFeFeFeFeFeFeFeFeFeFeFeFeFeFeFeFeFeFeFeFeFeFeFeFeFeFeFeFeFeFeFeFeFwa
AEeFhCeFeFeFeFeFeFeFeFeFeFeFhCeFeFeFeFeFeFeFeFeFeFeFeFeFeFhCeFeFeFeFeFeFeFeFeFeFeFeFeFeFeFeFeFeFeFwa
AEeFeFeFeFeFeFeFeFdxeFeFeFeFeFeFeFeFeFiJeFeFeFeFeFeFeFeFeFeFeFeFeFeFeFeFeFeFeFeFeFeFeFeFeFhCeFeFeFwa
AEeFeFdTeFSYeFeFdxnpdxeFtVDneFLYeFeFeFeFeFeFeFrSeFeFeFpneFeFqqqqeFeFeFeFeFeFeFeFeFeFeFeFeFeFeFeFeFwa
AEmqGZeFeFTNeFeFeFdxeFeFNMtVeFeFdxeFeFeFeFHkeFeFeFeFWwPNPNPNPNqqqqdxeFeFeFeFeFeFHHeFeFeFeFeFeFeFeFwa
AEeFeFfKeFeFeFeFeFeFeFfbeFeFeFdxnpdxeFeFeFeFHkeFeFeFqqqqwGqqqqqqdxnpdxeFeFeFeFeFeFeFeFeFeFeFeFeFeFwa
AEeFPAeFGZeFeFeFeFeFeFeFeFeFeFeFdxeFeFeFeFeFeFeFqqqqqqqqqqqqZvqqqqdxeFeFeFeFeFeFeFeFeFeFeFeFeFeFeFwa
AEeFeFeFeFeFeFeFeFeFeFeFIleFeFeFeFeFHkeFeFeFeFeFeFqqqqqqqqqqqqPNqqqqeFeFeFeFeFeFeFeFJmeFeFeFeFeFeFwa
AEeFeFeFeFeFeFeFeFeFeFeFeFsjeFIleFeFeFeFeFeFeFYneFeFCEPNqqwGbUPNeFdxeFeFeFeFeFeFeFeFeFeFeFeFeFeFeFwa
AEeFeFeFeFeFeFJmeFeFIleFIleFeFeFsjeFIleFdxeFeFeFeFeFeFPNPNPNPNPNdxnpdxeFeFeFeFeFeFeFeFeFeFeFeFeFeFwa
AEeFeFeFeFvueFeFeFeFeFeFeFeFIleFeFIleFdxnpdxeFeFeFLYeFeFeFeFXFeFeFdxeFeFeFeFeFeFeFeFeFeFeFeFeFeFJmwa
KBGNGNGNGNGNGNGNGNGNGNGNGNGNGNGNGNGNGNGNErGNGNGNGNGNGNGNGNGNGNGNGNGNGNGNGNGNGNGNGNGNGNGNGNGNGNGNGNrw
"}
